@@@@@@@@@@@@@@@@@@@@@@@@@@@@@@@@@@@@@@@@@@@@@@@@@@@@@@@@@@@@@@@@@@@@@@@@@@@@@@@@@@@@@@@@@@@@@@@@@@@@@@@@@@@@@@@@@@@@@@@@@@@@@@@@
@@@@@@@@@@@@@@@@@@@@@@@@@@@@@@@@@@@@@@@@@@@@@@@@@@@@@@@@@@@@@@@@@@@@@@@@@@@@@@@@@@@@@@@@@@@@@@@@@@@@@@@@@@@@@@@@@@@@@@@@@@@@@@@@
@@                                                                                                                            @@
@@                                                                                                                            @@
@@                                                                                                                            @@
@@                                                                                                                            @@
@@         @@                                                                                                                 @@
@@         @@                                                         @@                              @@@@@@@@@@@@            @@
@@         @@                                                         @@                                                      @@
@@         @@                                        @@@@@@@@@@@@@@@@@@@@@@@@@@@@@@@@@@@@                                     @@
@@         @@                                                         @@                                                      @@
@@         @@                                                         @@                                                      @@
@@                                                                                                                            @@
@@                                                                                                                            @@
@@                                                                                                                            @@
@@                      @@@@@@@@@@@@@@@@@@@@@                                                                                 @@
@@                                         @@                                                                                 @@
@@                                         @@                                                                                 @@
@@                                         @@                                                                                 @@
@@                                         @@                                                                                 @@
@@                                         @@                                                  @@                             @@
@@                                                                                             @@                             @@
@@        @@                                                                                   @@                             @@
@@        @@                                                                                   @@                             @@
@@        @@                                                  @@@@@@@@@@@@@@@@@@@@             @@                             @@
@@        @@                                                                                   @@                             @@
@@        @@                                                                                   @@                             @@
@@        @@@@@@@@@@@@@@@@@@@@@@@@                                                                                            @@
@@                                                                                                                            @@
@@                                                                                                                            @@
@@                                                                                                                            @@
@@                                                                                                                            @@
@@@@@@@@@@@@@@@@@@@@@@@@@@@@@@@@@@@@@@@@@@@@@@@@@@@@@@@@@@@@@@@@@@@@@@@@@@@@@@@@@@@@@@@@@@@@@@@@@@@@@@@@@@@@@@@@@@@@@@@@@@@@@@@@
@@@@@@@@@@@@@@@@@@@@@@@@@@@@@@@@@@@@@@@@@@@@@@@@@@@@@@@@@@@@@@@@@@@@@@@@@@@@@@@@@@@@@@@@@@@@@@@@@@@@@@@@@@@@@@@@@@@@@@@@@@@@@@@@