#######################################################################
#                                                                     #
#                                                                     #
#                                                                     #
#                                                                     #
#                                                                     #
#                                                                     #
#                                                                     #
#                                                                     #
#                                                                     #
#                                                                     #
#                                                                     #
#                                                                     #
#                                                                     #
#                                                                     #
#                                                                     #
#                                                                     #
#                                                                     #
#                                                                     #
#                                                                     #
#######################################################################