@@@@@@@@@@@@@@@@@@@@@@@@@@@@@@@@@@@@@@@@@@@@@@@@@@@@@@@@@@@@@@@@@@@@@@@@@@@@@@@@@@@@@@@@@@@@@@@@@@@@@@@@@@@@@@@@@@@@@@@@@@@@@@@@
@@@@@@@@@@@@@@@@@@@@@@@@@@@@@@@@@@@@@@@@@@@@@@@@@@@@@@@@@@@@@@@@@@@@@@@@@@@@@@@@@@@@@@@@@@@@@@@@@@@@@@@@@@@@@@@@@@@@@@@@@@@@@@@@
@@                                                                                                                            @@
@@                                                                                                                            @@
@@                                                                                                                            @@
@@                                                                                                                            @@
@@                                                                                                                            @@
@@                                                                                                                            @@
@@                                                                                                                            @@
@@                                                                                                                            @@
@@                                                                                                                            @@
@@                                                                                                                            @@
@@                                                                                                                            @@
@@                                                                                                                            @@
@@                                                                                                                            @@
@@                                                                                                                            @@
@@                                                                                                                            @@
@@                                                                                                                            @@
@@                                                                                                                            @@
@@                                                                                                                            @@
@@                                                                                                                            @@
@@                                                                                                                            @@
@@                                                                                                                            @@
@@                                                                                                                            @@
@@                                                                                                                            @@
@@                                                                                                                            @@
@@                                                                                                                            @@
@@                                                                                                                            @@
@@                                                                                                                            @@
@@                                                                                                                            @@
@@                                                                                                                            @@
@@                                                                                                                            @@
@@@@@@@@@@@@@@@@@@@@@@@@@@@@@@@@@@@@@@@@@@@@@@@@@@@@@@@@@@@@@@@@@@@@@@@@@@@@@@@@@@@@@@@@@@@@@@@@@@@@@@@@@@@@@@@@@@@@@@@@@@@@@@@@
@@@@@@@@@@@@@@@@@@@@@@@@@@@@@@@@@@@@@@@@@@@@@@@@@@@@@@@@@@@@@@@@@@@@@@@@@@@@@@@@@@@@@@@@@@@@@@@@@@@@@@@@@@@@@@@@@@@@@@@@@@@@@@@@